0 0 0 0 0 1 1 0 0 0 0 0
0 0 0 0 1 0 0 1 0 0 0 0
0 0 0 1 0 V V 0 1 0 0 0
0 0 1 0 2 V V 2 0 1 0 0
0 0 0 1 0 2 2 0 1 0 0 0
0 0 0 0 1 0 0 1 0 0 0 0
3 S 3 0 0 1 1 0 0 3 B 3
0 0 0 0 0 0 0 0 0 0 0 0