M 0 0 0 0 0 0 0 0 0 0 0
1 2 B 2 1 1 1 1 2 S 2 1
0 0 0 0 0 0 0 0 0 0 0 M
1 1 1 0 2 3 3 2 0 1 1 1
M 0 0 0 0 0 0 0 0 0 0 0
0 P 0 V 3 1 1 3 V 0 P 0
0 0 0 0 0 0 0 0 0 0 0 M
0 0 0 0 0 0 0 0 0 0 0 0